player_unit_total	7
player_unit_1	coralcrab
player_unit_2	dolphin
player_unit_3	mantaray
player_unit_4	sailfish
player_unit_5	snapper
player_unit_6	porcupine
player_unit_7	sunfish
enemy_unit_total	7
enemy_unit_1	anglerfish
enemy_unit_2	fangtooth
enemy_unit_3	gulpereel
enemy_unit_4	goblinshark
enemy_unit_5	isopod
enemy_unit_6	viperfish
enemy_unit_7	vampiresquid
coralcrab_unit_type_1	scissor
dolphin_unit_type_1	stone
mantaray_unit_type_1	paper
sailfish_unit_type_1	scissor
snapper_unit_type_1	stone
porcupine_unit_type_1	paper
sunfish_unit_type_1	scissor
anglerfish_unit_type_1	scissor
fangtooth_unit_type_1	stone
gulpereel_unit_type_1	paper
goblinshark_unit_type_1	scissor
isopod_unit_type_1	stone
viperfish_unit_type_1	paper
vampiresquid_unit_type_1	scissor